11111111111111111111111111111
10000000000000000010000001111
10010000000000000010000000001
10010000000111111110000000001
100100P0000000000000000W00001
11110000000000000000000000001
11111111111111111111111111111